TILE 0 0 5
TILE 0 1 5
TILE 0 2 5
TILE 0 3 5
Tile 0 4 5
